{
    "sequence": {
        "RES_1": [
            "ORD_36",
            "ORD_25",
            "ORD_20",
            "ORD_39",
            "ORD_23",
            "ORD_11",
            "ORD_07",
            "ORD_44",
            "ORD_42",
            "ORD_41",
            "ORD_09",
            "ORD_10",
            "ORD_22",
            "ORD_27",
            "ORD_45",
            "ORD_30",
            "ORD_28",
            "ORD_14",
            "ORD_53",
            "ORD_50",
            "ORD_08",
            "ORD_43",
            "ORD_38",
            "ORD_37",
            "ORD_06",
            "ORD_49",
            "ORD_51",
            "ORD_21",
            "ORD_40",
            "ORD_52",
            "ORD_54",
            "ORD_12",
            "ORD_24",
            "ORD_26",
            "ORD_13",
            "ORD_29",
            "ORD_47",
            "ORD_48",
            "ORD_46",
            "ORD_55",
            "ORD_05",
            "ORD_03",
            "ORD_32",
            "ORD_02",
            "ORD_16",
            "ORD_35",
            "ORD_33",
            "ORD_31",
            "ORD_15",
            "ORD_34",
            "ORD_17",
            "ORD_18",
            "ORD_19",
            "ORD_04",
            "ORD_01"
        ],
        "RES_2": [
            "ORD_36",
            "ORD_25",
            "ORD_20",
            "ORD_39",
            "ORD_23",
            "ORD_11",
            "ORD_07",
            "ORD_44",
            "ORD_42",
            "ORD_41",
            "ORD_09",
            "ORD_10",
            "ORD_22",
            "ORD_27",
            "ORD_45",
            "ORD_30",
            "ORD_14",
            "ORD_08",
            "ORD_53",
            "ORD_38",
            "ORD_28",
            "ORD_06",
            "ORD_43",
            "ORD_37",
            "ORD_21",
            "ORD_40",
            "ORD_50",
            "ORD_24",
            "ORD_26",
            "ORD_49",
            "ORD_52",
            "ORD_55",
            "ORD_51",
            "ORD_02",
            "ORD_05",
            "ORD_12",
            "ORD_54",
            "ORD_46",
            "ORD_16",
            "ORD_33",
            "ORD_29",
            "ORD_13",
            "ORD_31",
            "ORD_48",
            "ORD_15",
            "ORD_32",
            "ORD_34",
            "ORD_18",
            "ORD_17",
            "ORD_35",
            "ORD_19",
            "ORD_04",
            "ORD_47",
            "ORD_01",
            "ORD_03"
        ],
        "RES_3": [
            "ORD_36",
            "ORD_25",
            "ORD_39",
            "ORD_23",
            "ORD_11",
            "ORD_07",
            "ORD_42",
            "ORD_44",
            "ORD_09",
            "ORD_41",
            "ORD_10",
            "ORD_27",
            "ORD_45",
            "ORD_22",
            "ORD_20",
            "ORD_08",
            "ORD_14",
            "ORD_38",
            "ORD_28",
            "ORD_37",
            "ORD_40",
            "ORD_06",
            "ORD_21",
            "ORD_26",
            "ORD_53",
            "ORD_50",
            "ORD_43",
            "ORD_49",
            "ORD_52",
            "ORD_55",
            "ORD_51",
            "ORD_02",
            "ORD_05",
            "ORD_12",
            "ORD_54",
            "ORD_46",
            "ORD_16",
            "ORD_33",
            "ORD_30",
            "ORD_29",
            "ORD_13",
            "ORD_31",
            "ORD_48",
            "ORD_15",
            "ORD_32",
            "ORD_34",
            "ORD_18",
            "ORD_17",
            "ORD_35",
            "ORD_19",
            "ORD_24",
            "ORD_04",
            "ORD_47",
            "ORD_01",
            "ORD_03"
        ],
        "RES_4": [
            "ORD_36",
            "ORD_25",
            "ORD_39",
            "ORD_23",
            "ORD_07",
            "ORD_42",
            "ORD_09",
            "ORD_44",
            "ORD_41",
            "ORD_45",
            "ORD_10",
            "ORD_22",
            "ORD_14",
            "ORD_28",
            "ORD_27",
            "ORD_38",
            "ORD_06",
            "ORD_53",
            "ORD_50",
            "ORD_37",
            "ORD_49",
            "ORD_20",
            "ORD_52",
            "ORD_55",
            "ORD_51",
            "ORD_26",
            "ORD_08",
            "ORD_12",
            "ORD_11",
            "ORD_54",
            "ORD_46",
            "ORD_43",
            "ORD_21",
            "ORD_30",
            "ORD_29",
            "ORD_40",
            "ORD_13",
            "ORD_02",
            "ORD_16",
            "ORD_48",
            "ORD_05",
            "ORD_31",
            "ORD_33",
            "ORD_32",
            "ORD_15",
            "ORD_34",
            "ORD_18",
            "ORD_17",
            "ORD_35",
            "ORD_24",
            "ORD_04",
            "ORD_47",
            "ORD_19",
            "ORD_01",
            "ORD_03"
        ],
        "RES_5": [
            "ORD_36",
            "ORD_25",
            "ORD_39",
            "ORD_23",
            "ORD_07",
            "ORD_42",
            "ORD_09",
            "ORD_44",
            "ORD_41",
            "ORD_45",
            "ORD_10",
            "ORD_22",
            "ORD_28",
            "ORD_27",
            "ORD_38",
            "ORD_06",
            "ORD_53",
            "ORD_50",
            "ORD_49",
            "ORD_37",
            "ORD_52",
            "ORD_51",
            "ORD_55",
            "ORD_20",
            "ORD_12",
            "ORD_26",
            "ORD_54",
            "ORD_46",
            "ORD_43",
            "ORD_21",
            "ORD_11",
            "ORD_29",
            "ORD_14",
            "ORD_40",
            "ORD_16",
            "ORD_30",
            "ORD_13",
            "ORD_48",
            "ORD_08",
            "ORD_32",
            "ORD_05",
            "ORD_02",
            "ORD_31",
            "ORD_33",
            "ORD_15",
            "ORD_34",
            "ORD_18",
            "ORD_17",
            "ORD_35",
            "ORD_24",
            "ORD_04",
            "ORD_47",
            "ORD_19",
            "ORD_01",
            "ORD_03"
        ]
    },
    "objective": {
        "exp_objective": 4687.4,
        "obj_curve": [
            [
                0.09,
                5709.4
            ],
            [
                0.09,
                5649.4
            ],
            [
                0.1,
                4821.799
            ],
            [
                0.52,
                4782.2
            ],
            [
                0.7,
                4780.2
            ],
            [
                0.7,
                4777.2
            ],
            [
                0.7,
                4747.4
            ],
            [
                0.76,
                4746.4
            ],
            [
                0.87,
                4730.4
            ],
            [
                0.87,
                4697.4
            ],
            [
                0.98,
                4687.399
            ]
        ]
    }
}