{
    "sequence": {
        "RES_1": [
            "ORD_36",
            "ORD_25",
            "ORD_20",
            "ORD_39",
            "ORD_23",
            "ORD_11",
            "ORD_07",
            "ORD_44",
            "ORD_42",
            "ORD_41",
            "ORD_09",
            "ORD_10",
            "ORD_22",
            "ORD_27",
            "ORD_45",
            "ORD_08",
            "ORD_43",
            "ORD_38",
            "ORD_37",
            "ORD_06",
            "ORD_21",
            "ORD_40",
            "ORD_24",
            "ORD_26",
            "ORD_30",
            "ORD_28",
            "ORD_14",
            "ORD_53",
            "ORD_50",
            "ORD_49",
            "ORD_51",
            "ORD_52",
            "ORD_54",
            "ORD_12",
            "ORD_13",
            "ORD_29",
            "ORD_47",
            "ORD_48",
            "ORD_46",
            "ORD_55",
            "ORD_05",
            "ORD_03",
            "ORD_32",
            "ORD_02",
            "ORD_16",
            "ORD_35",
            "ORD_33",
            "ORD_31",
            "ORD_15",
            "ORD_34",
            "ORD_17",
            "ORD_18",
            "ORD_19",
            "ORD_04",
            "ORD_01"
        ],
        "RES_2": [
            "ORD_36",
            "ORD_25",
            "ORD_20",
            "ORD_39",
            "ORD_23",
            "ORD_11",
            "ORD_07",
            "ORD_44",
            "ORD_42",
            "ORD_41",
            "ORD_09",
            "ORD_10",
            "ORD_22",
            "ORD_27",
            "ORD_45",
            "ORD_08",
            "ORD_43",
            "ORD_38",
            "ORD_37",
            "ORD_06",
            "ORD_21",
            "ORD_40",
            "ORD_24",
            "ORD_26",
            "ORD_30",
            "ORD_28",
            "ORD_14",
            "ORD_50",
            "ORD_53",
            "ORD_54",
            "ORD_49",
            "ORD_12",
            "ORD_51",
            "ORD_13",
            "ORD_52",
            "ORD_29",
            "ORD_47",
            "ORD_48",
            "ORD_46",
            "ORD_55",
            "ORD_05",
            "ORD_02",
            "ORD_16",
            "ORD_31",
            "ORD_18",
            "ORD_15",
            "ORD_34",
            "ORD_17",
            "ORD_03",
            "ORD_32",
            "ORD_04",
            "ORD_01",
            "ORD_33",
            "ORD_35",
            "ORD_19"
        ],
        "RES_3": [
            "ORD_25",
            "ORD_20",
            "ORD_39",
            "ORD_11",
            "ORD_36",
            "ORD_42",
            "ORD_41",
            "ORD_09",
            "ORD_10",
            "ORD_22",
            "ORD_23",
            "ORD_08",
            "ORD_38",
            "ORD_07",
            "ORD_43",
            "ORD_06",
            "ORD_27",
            "ORD_45",
            "ORD_37",
            "ORD_26",
            "ORD_21",
            "ORD_24",
            "ORD_40",
            "ORD_30",
            "ORD_28",
            "ORD_14",
            "ORD_50",
            "ORD_53",
            "ORD_54",
            "ORD_49",
            "ORD_12",
            "ORD_51",
            "ORD_13",
            "ORD_52",
            "ORD_29",
            "ORD_47",
            "ORD_48",
            "ORD_46",
            "ORD_55",
            "ORD_44",
            "ORD_05",
            "ORD_31",
            "ORD_18",
            "ORD_16",
            "ORD_04",
            "ORD_32",
            "ORD_33",
            "ORD_03",
            "ORD_02",
            "ORD_35",
            "ORD_17",
            "ORD_19",
            "ORD_34",
            "ORD_01",
            "ORD_15"
        ],
        "RES_4": [
            "ORD_25",
            "ORD_20",
            "ORD_39",
            "ORD_11",
            "ORD_42",
            "ORD_09",
            "ORD_41",
            "ORD_36",
            "ORD_10",
            "ORD_07",
            "ORD_22",
            "ORD_43",
            "ORD_23",
            "ORD_08",
            "ORD_06",
            "ORD_45",
            "ORD_37",
            "ORD_38",
            "ORD_27",
            "ORD_26",
            "ORD_21",
            "ORD_24",
            "ORD_40",
            "ORD_30",
            "ORD_14",
            "ORD_28",
            "ORD_50",
            "ORD_51",
            "ORD_54",
            "ORD_13",
            "ORD_47",
            "ORD_48",
            "ORD_52",
            "ORD_29",
            "ORD_12",
            "ORD_46",
            "ORD_55",
            "ORD_53",
            "ORD_49",
            "ORD_44",
            "ORD_31",
            "ORD_18",
            "ORD_16",
            "ORD_04",
            "ORD_32",
            "ORD_33",
            "ORD_05",
            "ORD_03",
            "ORD_02",
            "ORD_35",
            "ORD_19",
            "ORD_17",
            "ORD_34",
            "ORD_01",
            "ORD_15"
        ],
        "RES_5": [
            "ORD_25",
            "ORD_20",
            "ORD_39",
            "ORD_11",
            "ORD_42",
            "ORD_09",
            "ORD_41",
            "ORD_36",
            "ORD_10",
            "ORD_07",
            "ORD_22",
            "ORD_43",
            "ORD_23",
            "ORD_08",
            "ORD_06",
            "ORD_45",
            "ORD_37",
            "ORD_38",
            "ORD_27",
            "ORD_26",
            "ORD_21",
            "ORD_24",
            "ORD_40",
            "ORD_30",
            "ORD_14",
            "ORD_28",
            "ORD_50",
            "ORD_53",
            "ORD_49",
            "ORD_51",
            "ORD_54",
            "ORD_13",
            "ORD_47",
            "ORD_48",
            "ORD_52",
            "ORD_29",
            "ORD_12",
            "ORD_46",
            "ORD_55",
            "ORD_44",
            "ORD_18",
            "ORD_16",
            "ORD_02",
            "ORD_31",
            "ORD_04",
            "ORD_33",
            "ORD_35",
            "ORD_19",
            "ORD_03",
            "ORD_32",
            "ORD_34",
            "ORD_05",
            "ORD_17",
            "ORD_01",
            "ORD_15"
        ]
    },
    "objective": {
        "exp_objective": 5325.400000000001,
        "obj_curve": [
            [
                0.44,
                6396.4
            ],
            [
                0.44,
                6258.4
            ],
            [
                0.44,
                5332.4
            ],
            [
                2.7,
                5325.4
            ]
        ]
    }
}